00000000000
00100000000
01101001110
00111111010
00001010010
00101111010
00111000010
00001101010
00100111010
00111100110
00000000000